WWWWW
WSWWW
W   W
WWW W
WE  W
WWWWW