WWWWWWWWWW
WSW   WEWW
W WWW W WW
W   W W  W
WWW W WW W
WWW      W
WWWWWWWWWW