20
14
WWWWWWWWWWWWWWWWWWWW
WWWWWWWWSWWWWWWWWWWW
WWWWWWWW   WWWWWWWWW
W        W WWWWW   W
W WWWW WWW WWWWW WWW
W WWWW WWW   WWW  WW
W   WW WW  W WWWW WW
WWW W  WWW W W    WW
WWW WW  WW W   WW WW
WWW WWW W  WWWWW   W
W   WWW    WWWWWW  W
WW  WW   W  WWWWW  W
WW      WWW   WWE  W
WWWWWWWWWWWWWWWWWWWW