10
10
1111111111
1101111001
1000222001
1000022011
1100222001
1100000011
1111001111
1100002222
1000222222
1112222222