20
10
11111111111111111111
11011110011122221122
10002220011221100022
10000220111000000222
11002220000000011012
11000000110000111222
11110011110011122222
11000022220000112002
10002222222200000022
11122222222222110002