20
20
11111111111111111111
11011110011122221122
10002220011221100022
10000220111000000222
11002220000000011012
11000000111000111222
11110011111011122222
11000022220000112002
10002222222200000022
11002222222222110012
11002222111221110011
11022220011210000111
10002200000011000011
11022100011111100001
11001110011110000111
11001111011111000011
11100011011110001122
11101000000000012222
11100010011002222222
11111111111222222222
